 ,Sprite/MapTest/Map3.txt , ,Sprite/MapTest/Map5.txt ,x : -3 y : -1
MMMMMMMMMMMMMMMMMMMMMMMMMMMMMM          MMMMMMMMMMMMMMMMMMMMMMMMMMMMMM
M                                                                    M
M                                                                    M
M                                                                    M
M                                                                    M
M                                                                    M
M                                                                    M
M                                                                    M
M                                                                    M
M                                                                    M
M                                                                    M
M                                                                    M
M                                                                    M
M                                                                    M
M                                                                    M
M                                                                    M
M                                                                    M
                                                                      
                                                                      
                                                                      
                                                                      
                                                                      
M                                                                    M
M                                                                    M
M                                                                    M
M                                                                    M
M                                                                    M
M                                                                    M
M                                                                    M
M                                                                    M
M                                                                    M
M                                                                    M
M                                                                    M
M                                                                    M
M                                                                    M
M                                                                    M
MMMMMMMMMMMMMMMMMMMMMMMMMMMMMMM          MMMMMMMMMMMMMMMMMMMMMMMMMMMMM
