 , ,Sprite/Maps/Map6.txt,Sprite/Maps/Map2.txt,
MMMMMMMMMMMMMMMMMMMMMMMMMMMMMMMMMMMMMMMMMMMMMMMMMMMMMMMMMMMMMMMMMMMMMM
M                                                                    M
M                                                                    M
M                                                                    M
M                                                                    M
M                          S                           S             M
M                                                                    M
M                                                                    M
M                                                                    M
M                                 3                                  M
M                                                                    M
M                                                                    M
M                                                                    M
                                                                     M
                                                                     M
                                                                     M
                                                                     M
                                                   S                 M
                                                                     M
                                                                     M
                                                                     M
                                                                     M
M                                                                    M
M                                                                    M
M                           S                                        M
M                                                                    M
M                                                                    M
M                                                                    M
M                                                                    M
M                                                                    M
M                                                                    M
M                                                                    M
M                                                                    M
M                                                                    M
M                                                                    M
M                                                                    M
MMMMMMMMMMMMMMMMMMMMMMMMMMMMM           MMMMMMMMMMMMMMMMMMMMMMMMMMMMMM
