Sprite/Maps/Map2.txt,Sprite/Maps/Map6.txt,Sprite/Maps/Map8.txt,Sprite/Maps/Map4.txt,
MMMMMMMMMMMMMMMMMMMMMMMMMMMMM           MMMMMMMMMMMMMMMMMMMMMMMMMMMMMM
M                                                                    M
M                                                                    M
M                                                                    M
M                                                                    M
M                                                                    M
M                                                                    M
M                                    F                               M
M                                                                    M
M                                                                    M
M                                                                    M
M                                                                    M
M                                                                    M









M                                                                    M
M                                                                    M
M                                                                    M
M                                                                    M
M                                                                    M
M                   T                                                M
M                                                                    M
M                                                                    M
M                                                                    M
M                                                                    M
M                                                                    M
M                                                                    M
M                                                                    M
M                                                                    M
MMMMMMMMMMMMMMMMMMMMMMMMMMMMM           MMMMMMMMMMMMMMMMMMMMMMMMMMMMMM
