Sprite/Maps/Map3.txt, ,Sprite/Maps/Map9.txt,Sprite/Maps/Map5.txt,
MMMMMMMMMMMMMMMMMMMMMMMMMMMMM           MMMMMMMMMMMMMMMMMMMMMMMMMMMMMM
M                                                                    M
M                                                                    M
M                                                                    M
M                                                                    M
M                                                                    M
M                                                                    M
M                            6                                       M
M                                                                    M
M                                                                    M
M                                                                    M
M                                                                    M
M                                                                    M
                                                                     M
                                                                     M
                                                                     M
                                                                     M
                                                                     M
                                                                     M
                                                                     M
                                                                     M
                                                                     M
M                                                                    M
M                                                                    M
M                                                                    M
M                                                                    M
M                                                                    M
M                                                                    M
M                                                                    M
M                                                                    M
M                                                                    M
M                                                                    M
M                                                                    M
M                                                                    M
M                                                                    M
M                                                                    M
MMMMMMMMMMMMMMMMMMMMMMMMMMMMM           MMMMMMMMMMMMMMMMMMMMMMMMMMMMMM
