Sprite/Maps/Map4.txt,Sprite/Maps/Map8.txt, , ,
MMMMMMMMMMMMMMMMMMMMMMMMMMMMM           MMMMMMMMMMMMMMMMMMMMMMMMMMMMMM
M                                                                    M
M                                                                    M
M                                                                    M
M                                                                    M
M                                                                    M
M                              T                                     M
M                                                                    M
M                                                                    M
M                                                                    M
M                                                                    M
M                                                                    M
M      T                                                             M
M
M
M
M
M
M
M
M
M
M                                                                    M
M                                                                    M
M      T                                                             M
M                                                                    M
M                                                T                   M
M                                                                    M
M                                                                    M
M                                                                    M
M                                                                    M
M                                                                    M
M                                                                    M
M                                                                    M
M                                                                    M
M                                                                    M
MMMMMMMMMMMMMMMMMMMMMMMMMMMMMMMMMMMMMMMMMMMMMMMMMMMMMMMMMMMMMMMMMMMMMM
