MMMMMMMMMMMMMMMMMMMMMMMMMMMMMMMMMMMMMMMMMMMMMMMMMMMMMMMMMMMMMMMMMMMMMMMMMMMMMMMMMMMMMMMMM
M                                                                                       M
M                                                                                       M
M                                                                                       M
M                                                                                       M
M                         T                                                             M
M                                                                                       M
M                                                                                       M
M                                                                                       M
M                                               T                                       M
M                                                                                       M
M                                        x                                              M
M                                                                                       M
M                                                                                       M
M                                                                                       M
M                                                    T                                  M
M                                                                                       M
M                                                                                       M
M                                                                                       M
M               T                                                                       M
M                                                                                       M
M                                                                                       M
M                                                                                       M
M                                                                                       M
M                                                                                       M
MMMMMMMMMMMMMMMMMMMMMMMMMMMMMMMMMMMMMMMMMMMMMMMMMMMMMMMMMMMMMMMMMMMMMMMMMMMMMMMMMMMMMMMMM
